111111111111111111111111111
10g0a00000000000000000000l1
1222222222222222222222222l1
1l00000000000000000000000l1
1l2222222222222222222222221
1l00000000000000000000000l1
1222222222222222222222222l1
1l00000000000000000000000l1
1l2222222222222222222222221
1l00000000000000000000000l1
1222222222222222222222222l1
1b10s00000000000000000000l1
121222222222222222222222221