111111111111111111111111111
100000000000000000000000001
100000000000000000000000001
100000000000000000000000001
100000000000000000000000001
100000000000000000000000001
100000000000000000000000001
100000000000000000000000001
100000b00000000000000000001
10000l200000000000000000001
10000l100000000000000000001
100g0l10000000000a000000s01
122222122222222222222222221