111111111111111111111111111
1000000000000000000001b0s01
1000000000g0000000000102221
1000000002222l0000000101001
1000000000000l0000000101001
1000000000000l0000000101001
1000000000000l0000000001001
1000000000000l0000000001001
100000000000l00022222201001
100000000000l00000000101001
100000000000l00000000101001
1000000000000000000000a1001
122222222222222222222221221