111111111111111111111111111
10000000000000b000000000001
100000000000000000000000001
100000000000000222200000001
100000000000000000100000001
1000000000000000g0100000001
100000000000000222100000001
100000000000000000000000001
100000000000000000000000001
100000a00000000000000000001
1000l222l000000000000000001
1000l000l00000000000000s001
122222222222222222222222221