111111111111111111111111111
100000000000uuu000000000001
100000000000000000000000001
100000000000000000000000001
10b000000000000000000000001
122200000000000000000000001
1111200000000000000l0000g01
1111120000000000000l2222221
1111110222000000000l1111111
1111110111222200000l0000001
1000000000000002000l00000m1
1000000s000000a1000l0000mm1
122222222222222122222222221


