111111111111111111111111111
10s000000000000000000000001
122200000000000000000000001
111100000000000000000000001
100002l00000000000000000001
100001l00000000000000000001
100001l00000000000000000001
100001l00000000000000000001
100001l00000000000000000001
100001l00000000000000000001
100001l00000000000000000001
10a001l0000020b00000000g001
122221222222122222222222221