mmmmmmmmmmmmmmmmmmmmmmmmmmm
m0000000000000000000000000m
m0000000000000000000000000m
m0000000000000000000000000m
m0000000000000000000000000m
m0000000000000000000000000m
m0000000000000000000000000m
m0000000000000000000000000m
m0000000000000000000000000m
m0000000000000000000000000m
m0000000000mm0000000000000m
m000000000mmm0000000000000m
mmmmmmmmmmmmmmmmmmmmmmmmmmm